0
0
0
0000000000000000000000200000000000000000000000000000000000000000000000000000000000222222220002223000000000000003000000000002220000233200000000000000000000000000000000000000000000000000000000066
0000000000000000000000000000000000000000000000000000000000000000000000000000000000000000000000000000000000000000000000000000000000000000000000000000000000000000000000000000000000000000000000666
0000000000000000000000000000000000000000000000000000000000000000000000000000000000000000000000000000000000000000000000000000000000000000000000000000000000000000000000000000000000000000000006666
00000000000000000000000000000000000000000000000000000000000000000030000000000000000000000000000000000000000000000000000000000000000000000000000000000000000000000000000000000000000000000000666660000000007
0000000000000000300024232000000000000000000000005000000000050000000000000000000242000000000000003000002300003003003000002000000000022000000600600000000006600660000000000002232000000000000666666
0000000000000000000000000080000800090000500000000000000000000000000000000000000000000000000000000000000000000000000000000000000000000000006600660000000066600666000000000000000000000000006666666
0000000000000000000000000000005000000000000000000008080000000000000000000000000000000000000008090800000000000000000000000000000000000000066600666000000666600666600000500008000800000050066666666
0000000000000000000000000000000000000000000000000000000000000000000000000000000000000000000000000000000000000000000000000000000000000000666600666600006666600666660000000000000000000000666666666
1111111111111111111111111111111111111111111111111111111111111111111111100111111111111111000111111111111111111111111111111111111111111111111111111111111111100111111111111111111111111111111111111111111111111111111111
1111111111111111111111111111111111111111111111111111111111111111111111100111111111111111000111111111111111111111111111111111111111111111111111111111111111100111111111111111111111111111111111111111111111111111111111